NO ./path_to_the_north_texture
SO ./path_to_the_south_texture
WE ./path_to_the_west_texture
EA ./path_to_the_east_texture


F 120,50,250
C 255,20,251

1111111111111111111111111
1000000000110000000000001
1011000001110000000000001
1001000000000000000000001
111111111111111111111111111111111
111111111011000001110000000000001
100000000011000001110111111111111
11110111111111011100000010001
1111011111111011101010010001
1100000011010101110100001000111
10000000000000001 1110000N010001
1000000000000000110101001000111
1100000111010101111101111000111
1111011101110101 101111010001
1111111111111111 111111111111