F 255 ,0, 0
C 0,255,0
			 
NO ./textures/wall_1/north.png
SO ./textures/wall_1/south.png
WE ./textures/wall_1/west.png
EA ./textures/wall_1/east.png
DO ./textures/wall_1/door.png

1111111111111111111111111
1000000000000000000000001
1000000000000000000000001
1000000000000000000000001
1000000000000000000000001
1000000000000000000000001
1000000000000000000000001
1000000000000000000000001
10000000001D1000000000001
1000000000DND000000000001
10000000001D1000000000001
1000000000000000000000001
1000000000000000000000001
1000000000000000000000001
1000000000000000000000001
1000000000000000000000001
1000000000000000000000001
1000000000000000000000001
1000000000000000000000001
1000000000000000000000001
1000000000000000000000001
1000000000000000000000001
1000000000000000000000001
1000000000000000000000001
1000000000000000000000001
1000000000000000000000001
1000000000000000000000001
1000000000000000000000001
1000000000000000000000001
1111111111111111111111111
