F 100 ,50, 1
C 10,10,10
			 
	
 
NO ./_zone_51/test_1.png
SO ./path_to_the_south_texture
WE ./path_to_the_west_texture
EA ./path_to_the_east_texture


1111111111111111111111111
10000000001100000S0000001
101100000111001000000001
1001000000000101101000001
1111111111111111111111111111111111
1111111110110000011100000000000001
1000000000110000011101111111111111
11110111111111011100000010001
1111011111111011101010010001
1100000011010101110100001000111
10000000000000001 1110000010001
1000000000000000110101001000111
1100000111010101111101111000111
111101110111011 1101111010001
111111111111111 1111111111111