111111
100011
100001
101001
111111