111111
100011
100001
110001
110001
101001
100001
100N01
101001
111111